



########################################################################################################################################################################################################
.               #############################                ############                                             ########                  ##################                       ## G ##       .
.                                                                                                                                                                                                      .
.                                                                                                                                                                                                      .
.                                                                                                                                                                                                      .
.                                                                                                                                                                                                      .
.                                                                                                                                                                                                      .
.                                                                                                                                                                                                      .
.                                                                                                                                                                                                      .
.                                                                                                                                                                                                      .
.                                                                                                                                                                                                      .
.                                                                                                                                                                                                      .
.                                                                                                                                                                                                      .
.                                                                                                                                                                                                      .
.                                                                                                                                                                                                      .
.                                                                                                                                                                                                      .
.                                                                                                                                                                                                      .
.                                                                                                                                                                                                      .
.                         ###########　　　　　　　　　　#######                                                                                                                  ######　　　######               .
########################################################################################################################################################################################################
